WE  ./texture_west.xpm
NO  ./texture_north.xpm
EA     ./texture_east.xpm
F      255   ,   0        ,0
R 1500 1500
SO     ./texture_south.xpm
S ./sprite.xpm
C 244,244,244

11111
11E01
11111