WE  ./texture_west.xpm
NA  ./texture_north.xpm
EA  ./texture_east.xpm

F 0,0,0
F 0 ,0,0
F 0,0,0


R 100 1001
SO  ./texture_south.xpm

        111111111         11111111111
       10000001          1000000000001
      100000011          100011110001
     10000001             11111  10001
    10000001                    100001
    10000001                    100001
   10000011  1111              100001
  10000001  10001             100001
 1000000111110001111         100001
 100000000100W000001        100001
 1000000000100000001      11000001
 111111111110000111      1000000111111
           100001         1000000000001
           100001         1111111110001
           100001                 10001
           1000011111111111111111110001
           100100000000000001000000001
           1000000000000000212000000001
           1111111111111111111111111111