R 1500  700

F

EA ./texture_east.xpm
WE ./texture_west.xpm
SO ./texture_south.xpm

NO ./texture_north.xpm

        111111111         111111111111
       10000001          1000000000001  
      100000011          1000111100001
     10000001             11111  100001 
    10000001                    100001
    10000001                    100001
   10000011  1111              100001
  10000001  10001             100001
 1000000111110001111         100001
 1000N00000000000001        100001
 1000000000000000001       1000001
 1111111111100001111      1000000111111
           100001         1000000000001
           100001         1111111110001
           100001                 10001
           1000011111111111111111110001
           1000000000000000000000000001
           1000000000000000000000000001
           1111111111111111111111111111