R                   1920 1080
F




        111111111111111111111111    
        100000000000000000000001
        100000000000000000000000           0
        10000000000000000000000011111111111
11111111100000000000000000000000111111
11000000000000000111110000000000011111111111
10000000000000011   1000000000111111111 1   
1100000000000000011110000000000001    
10000000000000000000000000001111111111111
1000000000000000000000000000111111
1000000000000000000000011111  
100000000000000010000000000011111111111
10000001 1000001 100000000001
11111111 11111111111111111111