R                   1920 1080
F




        111111111111111111111    
        100000000000000000001
        100000000000000000011
        111111111111111111111