R                   1920 1080
F




        111111111111111111111    
        100000000000000000001
        1000000000000N0000011
        111111111111111111111