WE  ./texture_west.xpm
NO  ./texture_north.xpm
EA     ./texture_east.xpm
F      255   ,   0        ,0
R 20000 200000
SO     ./texture_south.xpm
S ./sprite.xpm
C 244,244,244

         111111111        111111111111
       11200001          1000000000001
      10202011          1000111100011
     100000011           111111110001
    100010011                   100001
    10000N01                    100001
   10000011  1111              100001
  10000001  10001             100001
 1000000111110001111         100001
 1000000021000000001        100001
 1000000000100000001      11000001
 111111111110000111      1000000111111
           100001         1000000000001
           100001         1111111110001
           100001                 10001
           1000011111111111111111110001
           100100000000000001000000001
           1000000000000000010000000001
           1111111111111111111111111111